# «Кто хочет стать миллионером?» — педерача, в которой актеры гонятся за 3кк рублей (1кк евро/долларов/стерлингов, в странах с меньшей валютой 5кк), отвечая на вопросы и разводя зрителя на отправку смс.
кто	кто	PRON
хочет	хотеть	VERB
стать	стать	VERB
миллионером	миллионер	NOUN
педерача	педерача	NOUN
в	в	ADP
которой	который	PRON
актеры	актер	NOUN
гонятся	гониться	VERB
за	за	ADP
3кк	3кк	NUM
рублей	рубль	NOUN
1кк	1кк	NUM
евро	евро	NOUN
долларов	доллар	NOUN
стерлингов	стерлинг	NOUN
в	в	ADP
странах	страна	NOUN
с	с	ADP
меньшей	меньший	ADJ
валютой	валютая	NOUN
5кк	5кк	PROPN
отвечая	отвечать	VERB
на	на	ADP
вопросы	вопрос	NOUN
и	и	CCONJ
разводя	разводить	VERB
зрителя	зритель	NOUN
на	на	ADP
отправку	отправка	NOUN
смс	смс	NOUN

# Является излюбленной едой фотожабберов и развлекательных педерач.
является	являться	VERB
излюбленной	излюбленный	ADJ
едой	еда	NOUN
фотожабберов	фотожаббер	NOUN
и	и	CCONJ
развлекательных	развлекательный	ADJ
педерач	педерач	NOUN

# В 2019 году в одном из выпусков должны были играть звёзды «Что? Где? Когда?» Друзь и Сиднев.
в	в	ADP
2019	2019	ADJ
году	год	NOUN
в	в	ADP
одном	один	DET
из	из	ADP
выпусков	выпуск	NOUN
должны	должен	ADJ
были	быть	AUX
играть	играть	VERB
звёзды	звезда	NOUN
что	что	PRON
где	где	ADV
когда	когда	ADV
друзь	Друзь	PROPN
и	и	CCONJ
сиднев	Сиднев	PROPN

# Сыграли они так себе, забрав всего 200 тысяч рублёв.
сыграли	сыграть	VERB
они	они	PRON
так	так	ADV
себе	себя	PRON
забрав	забрать	VERB
всего	всего	ADV
200	200	NUM
тысяч	тысяча	NOUN
рублёв	рубль	NOUN

# Дальнейшие поиски выявили персонажа под ником AMDmitry.
дальнейшие	дальнейший	ADJ
поиски	поиск	NOUN
выявили	выявить	VERB
персонажа	персонаж	NOUN
под	под	ADP
ником	ник	NOUN
amdmitry	AMDmitry	X

# Одноименная страница AMDmitry в ЖЖ была удалена владельцем, и это был вин. В итоге найдены телефон и асечка Щетникова.
одноименная	одноименный	ADJ
страница	страница	NOUN
amdmitry	AMDmitry	X
в	в	ADP
жж	ЖЖ	NOUN
была	быть	AUX
удалена	удалить	VERB
владельцем	владелец	NOUN
и	и	CCONJ
это	это	PRON
был	быть	AUX
вин	вина	NOUN
в	в	ADP
итоге	итог	NOUN
найдены	найти	VERB
телефон	телефон	NOUN
и	и	CCONJ
асечка	асечка	NOUN
щетникова	Щетникова	PROPN

# Для нульча это неслыханное рвение, ибо нульч славится своим похуизмом.
для	для	ADP
нульча	нульча	NOUN
это	это	PRON
неслыханное	неслыханный	ADJ
рвение	рвение	NOUN
ибо	ибо	SCONJ
нульч	нульч	NOUN
славится	славиться	VERB
своим	свой	DET
похуизмом	похуизм	NOUN

# Однако, этим анон и ограничился — «всем похуй» одержало верх. Судя по активности Щетникова на торрентсру, он недолго боялся.
однако	однако	CCONJ
этим	это	PRON
анон	анон	NOUN
и	и	PART
ограничился	ограничиться	VERB
всем	все	PRON
похуй	похоять	VERB
одержало	одержать	VERB
верх	верх	NOUN
судя	судить	VERB
по	по	ADP
активности	активность	NOUN
щетникова	Щетникова	PROPN
на	на	ADP
торрентсру	торрентс	NOUN
он	он	PRON
недолго	недолго	ADV
боялся	бояться	VERB

# Уже через 5 дней ололокающий дебил кинулся навёрстывать упущенное.
уже	уже	ADV
через	через	ADP
5	5	NUM
дней	день	NOUN
ололокающий	ололокать	VERB
дебил	дебил	NOUN
кинулся	кинуться	VERB
навёрстывать	наверстывать	VERB
упущенное	упустить	VERB

# Зачем он так часто предваряет свои посты боевым кличем макак, остаётся загадкой.
зачем	зачем	ADV
он	он	PRON
так	так	ADV
часто	часто	ADV
предваряет	предварять	VERB
свои	свой	DET
посты	пост	NOUN
боевым	боевой	ADJ
кличем	клич	NOUN
макак	макак	NOUN
остаётся	оставаться	VERB
загадкой	загадка	NOUN

# Тот это Щетников или нет (фамилия не самая редкая), но поцыент прознал про эту статью и периодически на неё набигает… дурачок.
тот	тот	DET
это	это	PRON
щетников	Щетников	PROPN
или	или	CCONJ
нет	нет	PART
фамилия	фамилия	NOUN
не	не	PART
самая	самый	DET
редкая	редкий	ADJ
но	но	CCONJ
поцыент	поцыент	NOUN
прознал	прознать	VERB
про	про	ADP
эту	этот	DET
статью	статья	NOUN
и	и	CCONJ
периодически	периодически	ADV
на	на	ADP
неё	она	PRON
набигает	набигать	VERB
дурачок	дурачок	NOUN

# Как говорит он сам, он попал под раздачу как однофамилец исходного Щетникова, но и тут всем похуй.
как	как	SCONJ
говорит	говорить	VERB
он	он	PRON
сам	сам	DET
он	он	PRON
попал	попасть	VERB
под	под	ADP
раздачу	раздача	NOUN
как	как	SCONJ
однофамилец	однофамилец	NOUN
исходного	исходный	ADJ
щетникова	Щетникова	PROPN
но	но	CCONJ
и	и	PART
тут	тут	ADV
всем	все	PRON
похуй	похоять	VERB

# Поскольку начитка аудиокниги кажется простой задачей, многим надмозгам приходит в голову мысль: «а набубню-ка я в микрофон от гарнитуры очередной фанфик гаррипоттера и буду продавать/раздавать @ прославлюсь».
поскольку	поскольку	SCONJ
начитка	начитка	NOUN
аудиокниги	аудиокнига	NOUN
кажется	казаться	VERB
простой	простой	ADJ
задачей	задача	NOUN
многим	многий	DET
надмозгам	надмозгам	NOUN
приходит	приходить	VERB
в	в	ADP
голову	голова	NOUN
мысль	мысль	NOUN
а	а	CCONJ
набубню	набубнуть	VERB
ка	ка	INTJ
я	я	PRON
в	в	ADP
микрофон	микрофон	NOUN
от	от	ADP
гарнитуры	гарнитура	NOUN
очередной	очередной	ADJ
фанфик	фанфик	NOUN
гаррипоттера	гаррипоттер	NOUN
и	и	CCONJ
буду	быть	AUX
продавать	продавать	VERB
раздавать	раздавать	VERB
прославлюсь	прославиться	VERB

# В итоге получается нечто мерзкое, шепелявое, шумящее, сравнимое по качеству только с русским фандабом, удаляемое самим надмозгом после первого же прослушивания.
в	в	ADP
итоге	итог	NOUN
получается	получаться	VERB
нечто	нечто	PRON
мерзкое	мерзкий	ADJ
шепелявое	шепелявый	ADJ
шумящее	шумящий	ADJ
сравнимое	сравнимый	ADJ
по	по	ADP
качеству	качество	NOUN
только	только	PART
с	с	ADP
русским	русский	ADJ
фандабом	фандаб	NOUN
удаляемое	удалять	VERB
самим	сам	DET
надмозгом	надмозг	NOUN
после	после	ADP
первого	первый	ADJ
же	же	PART
прослушивания	прослушивание	NOUN

# Но иногда запись расползается по интернетам и взрывает мозг неосторожно послушавшим её аудиокниголюбам.
но	но	CCONJ
иногда	иногда	ADV
запись	запись	NOUN
расползается	расползаться	VERB
по	по	ADP
интернетам	интернет	NOUN
и	и	CCONJ
взрывает	взрывать	VERB
мозг	мозг	NOUN
неосторожно	неосторожно	ADV
послушавшим	послушать	VERB
её	ее	DET
аудиокниголюбам	аудиокниголюб	NOUN

# Здесь и победа может славы не принесть, А пораженье — заслужить аплодисменты.
здесь	здесь	ADV
и	и	PART
победа	победа	NOUN
может	мочь	VERB
славы	слава	NOUN
не	не	PART
принесть	принесть	VERB
а	а	CCONJ
пораженье	пораженье	NOUN
заслужить	заслужить	VERB
аплодисменты	аплодисмент	NOUN

# Хитрющие улыбки, уместное серьезное выражение лица, циничные фразочки и убойнейший махач – сценаристы молодцы, создали убойного вампир-хантера, но и Уэсли сделал все, как надо.
хитрющие	хитрющий	ADJ
улыбки	улыбка	NOUN
уместное	уместный	ADJ
серьезное	серьезный	ADJ
выражение	выражение	NOUN
лица	лицо	NOUN
циничные	циничный	ADJ
фразочки	фразочка	NOUN
и	и	CCONJ
убойнейший	убойнейший	ADJ
махач	махач	NOUN
сценаристы	сценарист	NOUN
молодцы	молодец	NOUN
создали	создать	VERB
убойного	убойный	ADJ
вампир-хантера	вампир-хантер	NOUN
но	но	CCONJ
и	и	PART
уэсли	Уэсли	PROPN
сделал	сделать	VERB
все	всё	PRON
как	как	ADV
надо	надо	VERB

# Стремясь помешать Блэйду в реализации его плана, верхушка вампиров во главе с Даникой Талосом натравливают на него людей.
стремясь	стремиться	VERB
помешать	помешать	VERB
блэйду	Блэйда	PROPN
в	в	ADP
реализации	реализация	NOUN
его	его	DET
плана	план	NOUN
верхушка	верхушка	NOUN
вампиров	вампир	NOUN
во	во	ADP
главе	глава	NOUN
с	с	ADP
даникой	Даника	PROPN
талосом	Талос	PROPN
натравливают	натравливать	VERB
на	на	ADP
него	он	PRON
людей	человек	NOUN

# А ты знаешь про эту поэму что-нить и ваще что надо про нее знать?
а	а	CCONJ
ты	ты	PRON
знаешь	знать	VERB
про	про	ADP
эту	этот	DET
поэму	поэма	NOUN
что-нить	что-нить	ADV
и	и	CCONJ
ваще	ваще	ADV
что	что	PRON
надо	надо	VERB
про	про	ADP
нее	она	PRON
знать	знать	VERB

# А уж квартирку мы когда-нить потом оформим.
а	а	CCONJ
уж	уж	PART
квартирку	квартирка	NOUN
мы	мы	PRON
когда-нить	когда-нить	ADV
потом	потом	ADV
оформим	оформить	VERB

# Форму соблюсти, а по сути, плюнуть на МОК.
форму	форма	NOUN
соблюсти	соблюстить	VERB
а	а	CCONJ
по	по	ADP
сути	суть	NOUN
плюнуть	плюнуть	VERB
на	на	ADP
мок	МОК	PROPN

# Прокладывать ВОК на расстояния менее 20 метров невыгодно, а протяжка десятков патч-кордов весьма трудоемкая задача.
прокладывать	прокладывать	VERB
вок	ВОК	NOUN
на	на	ADP
расстояния	расстояние	NOUN
менее	менее	ADV
20	20	NUM
метров	метр	NOUN
невыгодно	невыгодный	ADJ
а	а	CCONJ
протяжка	протяжка	NOUN
десятков	десяток	NOUN
патч	патч	NOUN
-кордов	-корд	NOUN
весьма	весьма	ADV
трудоемкая	трудоемкий	ADJ
задача	задача	NOUN

# Заболотных Е. А..  Перепись домовладельцев Екатеринбурга 1913 г.: информационные возможности источника для реконструкции религиозного ландшафта города.
заболотных	Заболотный	PROPN
перепись	перепись	NOUN
домовладельцев	домовладелец	NOUN
екатеринбурга	Екатеринбург	PROPN
1913	1913	ADJ
информационные	информационный	ADJ
возможности	возможность	NOUN
источника	источник	NOUN
для	для	ADP
реконструкции	реконструкция	NOUN
религиозного	религиозный	ADJ
ландшафта	ландшафт	NOUN
города	город	NOUN

# Еще в древности буддисты и даосы знали, что пустота есть сущность бытия "шуньята — это татхата ".
еще	еще	ADV
в	в	ADP
древности	древность	NOUN
буддисты	буддист	NOUN
и	и	CCONJ
даосы	даос	NOUN
знали	знать	VERB
что	что	SCONJ
пустота	пустота	NOUN
есть	быть	VERB
сущность	сущность	NOUN
бытия	бытие	NOUN
шуньята	шуньята	NOUN
это	это	PART
татхата	татхата	NOUN

# — На других огородах арбузята родятся мелкие, кислые.
на	на	ADP
других	другой	DET
огородах	огорода	NOUN
арбузята	арбузят	NOUN
родятся	родиться	VERB
мелкие	мелкий	ADJ
кислые	кислый	ADJ

